b	不 办 本 便 步 被 比 并 表 报 必
c	出 参 才 处 常 产 车 长 场 重 程
d	的 队 到 多 点 定 但 地 都 动 等
f	发 费 否 风 峰 法 房 放 反 服 父
g	个 改 工 各 光 关 功 果 更 感 该
h	和 红 花 后 黑 活 化 很 何 合 海
j	就 己 机 今 叫 将 觉 间 加 金 接
k	可 恳 克 科 肯 空 况 刻 客 苦 考
l	了 灵 两 脸 路 冷 林 老 理 连 龙
m	没 马 模 们 吗 美 满 么 命 目 每
n	你 能 弄 拿 呢 宁 男 女 难 娘 哪
p	平 陪 排 朋 跑 派 普 旁 批 配 拍
q	去 群 其 气 器 情 亲 却 轻 清 青
r	人 忍 热 入 肉 认 柔 任 容 仍 软
s	是 书 声 生 时 实 三 身 所 什 十
t	他 通 太 特 听 它 统 提 题 条 突
v	而 娥 耳 爱 啊 案 欧 尔 按 恩 恶
w	我 屋 王 位 网 问 五 文 望 万 未
x	下 细 现 行 些 学 先 向 相 新 信
y	一 以 要 月 业 应 样 已 又 于 与
z	在 展 走 知 只 这 真 之 作 主 再
ba	边 编 避 婢 巴 臂 绷 绑 剥 驳 陛
be	把 毕 帮 百 标 霸 板 抱 班 奔 杯
bi	别 败 背 贝 罢 卜 跋 悲 鄙 崩 彪
bo	部 遍 病 爆 闭 波 辩 冰 补 宾 辨
bu	白 备 笔 彼 保 爸 拜 包 兵 伯 版
ca	除 纯 层 承 陈 翠 丑 迟 尺 缠 驰
ce	成 村 蠢 厂 城 刺 唇 超 藏 朝 残
ci	此 财 餐 尘 吹 尝 喘 唱 晨 昌 齿
co	次 词 冲 差 闯 窗 诚 充 床 测 惨
cu	从 触 错 船 仇 采 彩 称 创 策 促
da	对 殿 导 邓 蛋 登 刁 陡 叠 逮 凳
de	大 顿 掉 达 担 顶 抵 杜 丁 夺 抖
di	当 瞪 督 呆 典 党 迪 盯 赌 旦 跌
do	道 读 度 弟 单 淡 店 断 底 端 洞
du	得 独 第 待 倒 爹 短 代 答 低 胆
fa	飞 纷 弗 妨 防 附 纺 缝 妃 缚 绯
fe	夫 扶 丰 奋 封 奉 枫 芳 抚 菲 赴
fi	非 幅 啡 赋 吩 咐 贩 帆 蜂 斐 蝠
fo	方 福 疯 烦 访 富 废 泛 愤 浮 冯
fu	分 负 符 返 佛 翻 仿 付 凡 伏 锋
ga	给 贯 敢 姑 孤 观 癸 隔 弓 纲 艮
ge	过 戈 规 顾 共 格 赶 故 革 构 攻
gi	国 贵 购 归 骨 固 冈 岗 跪 咕 嘎
go	高 冠 郭 盖 阁 怪 割 宫 滚 惯 诡
gu	公 够 钢 瓜 鬼 谷 勾 股 馆 狗 乖
ha	好 缓 骇 贺 函 幻 憨 绘 弘 弧 骅
he	还 划 魂 厚 换 霍 互 挥 画 获 韩
hi	回 喝 虎 哈 呼 辉 呵 号 喊 哼 嘿
ho	话 户 毫 火 湖 汉 豪 寒 河 恨 混
hu	会 昏 皇 航 候 含 毁 伙 货 侯 狐
ja	经 结 建 娇 阶 劲 纪 绝 局 居 既
je	进 较 静 奇 极 夹 救 据 技 击 境
ji	见 具 睛 尖 紧 坚 距 景 监 旧 甲
jo	家 计 交 精 决 济 举 惊 军 竟 京
ju	几 及 简 近 件 剑 久 急 集 九 脚
ka	孔 尻 隗 垦 绔 纩 凵 骒 缂 娔 哿
ke	开 恐 刊 矿 块 款 堪 抗 扩 括 扣
ki	口 哭 咖 咳 眶 昆 旷 叩 喀 咯 吭
ko	快 课 康 寇 库 宽 慨 愧 渴 裤 窥
ku	看 侃 靠 铿 魁 馈 龛 铐 筐 胯 傀
la	力 绿 录 络 陆 陵 履 隆 辽 骆 姥
le	来 轮 琳 历 李 雷 丽 联 露 楼 烈
li	里 罗 虑 劣 临 啦 卢 略 累 吕 龄
lo	立 论 离 类 六 流 凌 料 亮 刘 泪
lu	利 留 黎 律 例 邻 俩 伦 鲁 狼 铃
ma	民 母 弥 妈 眉 买 媚 妙 孟 姆 矛
me	面 迈 麦 码 某 灭 慕 梅 蒙 卖 玛
mi	明 默 嘛 冒 骂 盟 墨 曼 眸 鸣 帽
mo	门 谋 麻 米 闷 密 漫 慢 迷 摩 漠
mu	名 免 秘 脉 魅 貌 猫 穆 牧 勉 秒
na	那 纽 尼 怒 乃 奶 嫩 娜 妮 奴 妞
ne	南 捏 拟 奈 聂 挪 酿 孽 霓 拧 匿
ni	内 喃 虐 呐 睨 嗯 嗫 哝 蹑 咛 昵
no	农 诺 泥 逆 恼 浓 溺 衲 涅 粘 讷
nu	年 鸟 狞 腻 您 倪 恁 钮 袅 黏 馁
pa	皮 屁 劈 颇 屏 譬 嫖 辟 嫔 缥 辔
pe	破 抛 坡 扑 飘 拼 蓬 披 捧 彭 攀
pi	品 喷 频 盼 裴 帕 噗 赔 畔 啪 啤
po	怕 评 疲 瓶 袍 漂 泼 瞥 潘 叛 泡
pu	片 鹏 篇 盘 迫 贫 铺 佩 仆 爬 胖
qa	强 骑 屈 纤 驱 劝 绻 绮 嫱 逡 缱
qe	起 切 球 奇 求 取 枪 确 七 秦 桥
qi	且 瞧 曲 圈 晴 岂 歧 遣 雀 囚 跄
qo	前 启 庆 拳 弃 悄 恰 旗 潜 汽 敲
qu	全 欠 秋 缺 倾 乔 卿 签 躯 侵 丘
ra	如 妊 绒 娆 纫 孺 鶸 缛 媶 邚 嬫
re	若 惹 蓉 辱 荣 融 茹 扔 揉 芮 蕊
ri	日 嚷 睿 蠕 冉 嚅 喏 蹂 嵘 蚋 蚺
ro	让 溶 冗 汝 润 染 衽 熔 闰 濡 禳
ru	然 偌 锐 仞 仁 儒 壬 饪 箬 稔 穰
sa	双 丝 司 始 收 圣 绍 随 孙 属 尸
se	事 输 式 石 斯 霜 甚 术 士 示 树
si	上 水 叔 师 思 尚 岁 虽 省 史 睡
so	说 神 商 数 闪 深 识 设 社 视 送
su	手 色 算 失 似 食 顺 伤 胜 伸 适
ta	她 弹 退 屠 陶 陀 迢 驼 婷 臀 屉
te	天 投 泰 态 推 探 挑 厅 抬 套 塔
ti	同 图 田 团 叹 吐 蹄 贴 踏 踢 棠
to	头 谈 唐 童 讨 汤 亭 庭 疼 涛 涂
tu	体 腿 铁 透 偷 逃 甜 途 腾 躺 廷
va	阿 屙 隘 嫒 婀 媪 妿 妸 娭 隞 隌
ve	二 厄 敖 碍 挨 熬 扼 噩 萼 拗 蔼
vi	暗 岸 唉 哦 昂 哎 峨 喔 黯 噢 呃
vo	安 懊 谙 庵 袄 澳 鏖 讹 讴 洱 谔
vu	儿 俺 矮 肮 傲 偶 翱 饵 鳄 皑 迩
wa	维 婉 慰 娃 卫 尾 妩 尉 纬 毋 娓
we	无 瓦 玩 威 吾 雾 挖 韦 碗 薇 挽
wi	晚 味 唯 吴 吻 喂 晤 哇 呜 胃 唔
wo	为 谓 亡 湾 闻 温 宛 弯 污 悟 惟
wu	外 务 物 微 伟 翁 午 委 稳 危 乌
xa	线 续 寻 姓 险 习 迅 乡 限 戏 陷
xe	想 邪 型 雄 幸 需 夏 雪 醒 校 萧
xi	小 兄 虚 响 显 削 吓 县 吸 晓 啸
xo	心 谢 效 羞 闲 兴 宣 消 写 席 序
xu	笑 系 香 须 像 希 仙 血 选 修 秀
ya	也 约 异 盈 院 预 验 阳 阴 隐 勇
ye	有 雅 云 友 英 元 亚 运 越 愿 严
yi	眼 员 呀 易 影 耀 园 遇 叶 央 野
yo	意 语 衣 义 阅 游 亦 音 夜 育 永
yu	用 疑 银 御 依 余 印 优 迎 欲 移
za	子 终 织 姊 阵 纵 驻 纸 阻 召 障
ze	正 转 专 左 者 震 找 直 政 至 招
zi	中 早 战 照 足 掌 咱 止 嘴 助 罪
zo	着 祖 资 总 治 字 装 站 准 注 族
zu	自 周 种 质 住 坐 造 做 制 众 追
bb	并不 半边 本报 不便 宝贝 不必 报表 宝宝 爸爸 不变 版本
bc	不错 奔驰 变成 报仇 彼此 不曾 本次 保持 不成 补充 保存
bd	不得 不对 不大 不但 不当 不断 表达 报道 别的 部队 必定
bf	办法 不妨 冰封 部分 并非 北方 颁发 步伐 播放 备份 爆发
bg	不过 不敢 罢工 不管 宝贵 不高 宾馆 报告 不够 不顾 办公
bh	保护 不好 变换 变化 编号 北海 不回 背后 不会 包含 百货
bj	不仅 巴结 不禁 不久 不见 北京 不解 比较 毕竟 不及 不觉
bk	不肯 鼻孔 包括 本科 被困 不快 便可 避开 不堪 博客 板块
bl	本来 罢了 不理 巴黎 变量 不论 办理 不料 本领 玻璃 冰冷
bm	部门 不妙 表面 罢免 表明 不满 帮忙 避免 不免 不明 把门
bn	半年 不能 别扭 百年 保暖 不宁 比你 帮你 把你 不难 本能
bp	不怕 被骗 编排 被迫 本品 背叛 本篇 本片 奔跑 被判 帮派
bq	表情 不强 版权 标签 并且 不清 病情 兵器 不起 比起 抱歉
br	别人 不如 般若 不然 本日 不容 比如 必然 本人 病人 不忍
bs	表示 本书 办事 本身 不少 比赛 白色 不时 半晌 别说 博士
bt	不同 不通 半天 摆脱 标题 把它 把他 白天 本帖 不太 不停
bv	不安 贝阿 北欧 不爱 彼岸 备案 办案 保安 悲哀 比尔 贝尔
bw	把握 保卫 百万 把我 本网 不问 并未 本文 帮我 部位 比我
bx	必须 保险 不想 不行 不小 不许 不详 表现 不幸 八仙 不限
by	不要 不已 必要 不用 不易 表演 扮演 毕业 本页 不愿 本月
bz	不住 保障 不再 部长 帮助 保证 不止 标准 不足 不准 脖子
cb	出版 承办 成本 苍白 初步 传遍 从不 传播 差别 翅膀 崇拜
cc	常常 传出 尺寸 匆匆 从此 层次 处处 财产 长长 抽出 存储
cd	程度 车队 颤抖 吃得 差点 彻底 长度 承担 冲动 成都 菜单
cf	充分 长发 查封 吃饭 除非 厨房 成分 采访 重复 财富 处罚
cg	成功 参观 超过 持股 成果 超高 穿过 采购 错过 出国 唱歌
ch	窗户 才好 策划 才会 称呼 仇恨 彩虹 称号 场合 此后 词汇
cj	参加 曾经 促进 长久 常见 成就 长江 长剑 成绩 吃惊 刺激
ck	此刻 诚恳 参考 查看 出口 仓库 察看 窗口 存款 残酷 乘客
cl	出来 除了 处理 彩铃 策略 成立 传来 从来 材料 产量 成了
cm	充满 村民 场面 成名 聪明 出门 出卖 沉默 传媒 层面 侧面
cn	才能 超女 嘲弄 菜鸟 车内 承诺 采纳 常年 处女 产能 成年
cp	产品 彩屏 彩票 唱片 出品 裁判 诚聘 磁盘 成品 超频 测评
cq	采取 超强 长期 春秋 插曲 从前 初期 产权 重庆 传奇 此前
cr	承认 脆弱 耻辱 仇人 次日 从容 超人 成人 插入 此人 残忍
cs	此时 纯属 从事 出手 才是 城市 成熟 产生 措施 测试 沉思
ct	传统 出台 餐厅 朝廷 长叹 冲突 从头 春天 长途 此贴 此帖
cv	从而 嫦娥 尘埃 宠爱 此岸 长安 差额 草案 此案 初二 刺耳
cw	成为 创维 从未 此外 春晚 错误 常务 称为 窗外 财务 宠物
cx	出现 持续 呈现 朝鲜 从小 程序 成效 重新 出席 创新 查询
cy	产业 诧异 参与 采用 成员 创意 草原 沉吟 处于 迟疑 出于
cz	存在 车子 财政 操作 从中 穿着 城镇 创造 沉重 创作 成长
db	代表 躲避 打扮 担保 地步 大半 对比 大步 多半 东北 都不
dc	调查 得出 达成 到处 对此 当初 低沉 多次 当场 当成 单纯
dd	得到 导弹 达到 等待 地点 到底 大大 地道 淡淡 当地 等到
df	地方 打发 大夫 对付 大幅 对方 东风 东方 大方 得分 到访
dg	大哥 大纲 大概 多个 德国 蛋糕 点歌 灯光 帝国 东莞 订购
dh	的话 多好 动画 大会 带回 电话 导航 大汉 都会 对话 等候
dj	大家 大局 打击 多久 大叫 东京 点击 当今 代价 动静 登记
dk	打开 打孔 贷款 都看 端口 带宽 大口 对抗 抵抗 都快 雕刻
dl	带来 得了 道理 带领 大量 独立 大陆 大力 道路 打量 到来
dm	多么 大马 对面 多名 东盟 大门 大名 地面 代码 动漫 都没
dn	多年 都能 东南 当年 党内 大闹 到您 电脑 当你 对你 到你
dp	大批 肚皮 打破 大盘 毒品 点评 地盘 搭配 大片 店铺 短片
dq	地区 党群 的确 大全 电器 当前 对其 地球 道歉 的钱 定期
dr	当然 刀刃 打扰 敌人 当日 点燃 陡然 大人 道人 担任 动人
ds	但是 读书 低声 打算 多少 电视 动手 当时 地上 大师 倒是
dt	点头 对她 动态 独特 打听 低头 当他 当天 地图 对他 但他
dv	第二 对阿 大二 点儿 对啊 答案 对岸 档案 戴尔 定额 东欧
dw	单位 大卫 第五 地位 当晚 大为 对我 队伍 党委 动物 对外
dx	东西 短线 地下 对象 大小 担心 大喜 大学 大型 底下 低下
dy	第一 大约 对于 地狱 电影 答应 对应 定义 得意 党员 等于
dz	弟子 肚子 当真 动作 当中 带着 多种 斗争 读者 电子 当作
fb	分别 反驳 发表 方便 腐败 封闭 发病 分布 发布 风暴 法宝
fc	非常 付出 方才 风采 发财 房产 复仇 扶持 分成 放出 飞船
fd	反对 辅导 负担 非但 非典 奋斗 发达 发动 饭店 发抖 反倒
ff	方法 纷纷 防范 仿佛 吩咐 丰富 复发 夫妇 非法 反复 发放
fg	法国 发给 放过 分管 风光 覆盖 发光 法规 风格 分割 法官
fh	发挥 粉红 防护 符合 返回 复活 废话 复合 凤凰 符号 发货
fj	房间 福建 飞机 附近 风景 发觉 佛教 分解 附件 房价 附加
fk	放开 复垦 分开 疯狂 封口 访客 飞快 反抗 付款 反馈 罚款
fl	法律 翻了 飞龙 福利 房里 分类 飞来 分离 风流 分裂 飞了
fm	方面 父母 封面 风貌 分明 房门 阀门 发明 丰满 抚摸 负面
fn	妇女 愤怒 抚弄 飞鸟 房内 烦恼 发难 方能 发怒 父女 粉嫩
fp	分配 放屁 发票 扶贫 废品 反叛 发泡 肥胖 复牌 发片 分批
fq	父亲 奉劝 夫妻 风气 分歧 放弃 番茄 风情 发起 分区 飞去
fr	夫人 缝纫 繁荣 妇人 肥肉 否认 富人 芙蓉 法人 放入 发热
fs	发生 附属 方式 翻身 凡是 发送 风声 放松 发誓 放手 分手
ft	发帖 反弹 飞天 繁体 发贴 法庭 风头 附图 丰田 访谈 沸腾
fv	反而 份额 妨碍 菲尔 飞蛾 方案 费尔 法案 风儿 飞儿 肺癌
fw	服务 房屋 发威 飞舞 范围 访问 防伪 分为 氛围 风味 富翁
fx	发现 风险 分析 方向 反响 放心 分享 放下 发行 奉献 飞行
fy	反应 法院 飞扬 费用 反映 发言 房源 富有 翻译 风云 防御
fz	发展 房子 负责 分钟 否则 非洲 法子 反正 复杂 犯罪 方针
gb	根本 改编 公布 官兵 告别 干部 贵宾 改变 广播 关闭 个别
gc	工程 高层 刚才 过程 歌唱 观察 工厂 贯彻 构成 干脆 广场
gd	感到 宫殿 广大 孤独 观点 规定 高大 各地 高度 赶到 感动
gf	功夫 国防 规范 股份 高峰 广泛 各方 工夫 过分 官方 购房
gg	改革 更改 哥哥 各个 刚刚 古怪 尴尬 各国 格格 广告 乖乖
gh	规划 搞好 更换 过后 光辉 关怀 供货 刚好 更好 工会 公会
gj	国家 国际 根据 关键 工具 感觉 公斤 更加 各级 感激 攻击
gk	公开 管孔 高考 观看 港口 赶快 感慨 顾客 广阔 更快 过客
gl	管理 功力 过来 规律 公路 各类 攻略 公里 鼓励 过了 光临
gm	革命 购买 规模 改名 高明 歌迷 感冒 光芒 公民 国民 光明
gn	姑娘 功能 赣南 观念 国内 工农 过年 概念 给你 给您 跟你
gp	公平 滚屏 股票 光盘 高频 各派 狗屁 挂牌 该片 古朴 攻破
gq	过去 光驱 供求 国企 歌曲 感情 过期 跟前 敢情 股权 钢琴
gr	果然 刚柔 光荣 工人 骨肉 感染 给人 怪人 固然 各人 国人
gs	告诉 公司 故事 高手 更是 改善 拱手 感受 高速 工商 高声
gt	共同 沟通 国土 个体 感叹 过头 港台 给他 给她 钢铁 跟他
gv	公安 关隘 高二 关爱 感恩 港澳 国安 孤儿 个案 高昂 高额
gw	各位 恭维 国王 国外 官网 更为 顾问 怪物 岗位 给我 购物
gx	关系 光线 阁下 购销 功勋 高兴 甘心 关心 贡献 感谢 个性
gy	关于 怪异 国有 公用 工业 故意 供应 官员 共有 根源 怪异
gz	工作 公子 公正 各种 规则 跟着 关注 公主 各自 改造 观众
hb	好不 回避 毫不 伙伴 河北 何必 火爆 货币 环保 湖北 还不
hc	何处 画出 火车 好处 好吃 缓冲 换成 合成 很长 缓存 号称
hd	活动 会对 回到 回答 蝴蝶 皇帝 好多 很多 获得 忽地 何等
hf	恢复 花费 回覆 回复 横幅 合法 哈佛 合肥 划分 护肤 后方
hg	回归 宏观 回顾 换个 韩国 很高 合格 后果 还给 火光 化工
hh	缓缓 好好 绘画 狠狠 哈哈 后悔 呼唤 嘿嘿 呵呵 黄河 黄昏
hj	环境 韩剧 环节 好几 会见 回家 痕迹 喝酒 黄金 伙计 好久
hk	很快 汗孔 汇款 好看 户口 何况 花开 航空 黑客 海口 还可
hl	回来 活力 后来 混乱 喉咙 婚礼 怀里 合理 欢乐 好了 含量
hm	后面 黑马 号码 毫秒 好吗 昏迷 毁灭 还没 画面 缓慢 毫米
hn	河南 很难 湖南 怀念 回暖 胡闹 好难 还能 海南 华南 华纳
hp	害怕 黑屏 琥珀 魂魄 货品 好评 划破 活泼 惠普 湖泊 花瓶
hq	回去 很强 好奇 花钱 火器 行情 会去 获取 环球 后期 后勤
hr	忽然 环绕 火热 好人 韩日 会让 后人 华人 坏人 黑人 赫然
hs	还是 回收 好事 浑身 和尚 话说 黑色 皇上 或是 会上 函数
ht	回头 后退 航天 话筒 话题 会谈 好听 合同 糊涂 回帖 后台
hv	黑暗 姮娥 和蔼 会儿 好啊 毫安 很爱 海尔 花儿 海岸 昏暗
hw	毫无 后卫 好玩 海外 回味 化为 华为 户外 货物 还未 红外
hx	或许 和弦 互相 好像 呼吸 核心 好心 含笑 好笑 欢喜 好些
hy	还有 何以 还要 怀疑 行业 会议 黑影 欢迎 花园 回忆 婚姻
hz	孩子 汉子 或者 合作 怀中 汉字 还在 胡子 好在 会长 杭州
jb	基本 举办 绝不 肩膀 脚步 疾病 具备 决不 进步 级别 金币
jc	基础 基层 坚持 进程 经常 警察 就此 检查 接触 决策 建成
jd	觉得 绝对 见到 记得 监督 决定 军队 简单 巨大 激动 阶段
jf	解放 经费 姐夫 肌肤 绝非 警方 几分 积分 减肥 纠纷 激发
jg	结果 交给 经过 尽管 金刚 机关 加工 结构 机构 价格 警告
jh	几乎 结婚 计划 机会 惊呼 江湖 交换 结合 家伙 讲话 今后
jj	经济 拒绝 积极 接近 紧紧 解决 坚决 究竟 渐渐 姐姐 将军
jk	加快 祭孔 解开 就看 接口 健康 即可 尽快 进口 剑客 艰苦
jl	建立 极了 进来 纪律 尽量 距离 记录 将来 交流 经历 激烈
jm	见面 居民 局面 经贸 节目 急忙 精美 寂寞 紧密 界面 加盟
jn	今年 艰难 江南 近年 境内 拘泥 几年 纪念 技能 就能 济南
jp	金牌 精辟 机票 键盘 精品 浸泡 就怕 极品 奖品 就跑 解剖
jq	加强 坚强 进去 健全 机器 交情 减轻 及其 举起 极其 惊奇
jr	进入 假如 金融 既然 今日 就让 近日 居然 竟然 加入 家人
js	建设 介绍 技术 接受 加上 精神 计算 就算 即使 解释 结束
jt	今天 交通 几天 具体 集团 家庭 简体 集体 肩头 交谈 教堂
jv	骄傲 金娥 进而 饥饿 激昂 金额 惊愕 教案 巨额 继而 煎熬
jw	极为 结尾 紧握 交往 今晚 绝望 几位 均为 叫我 较为 仅为
jx	进行 继续 脚下 举行 揭晓 决心 惊喜 教训 教学 景象 机械
jy	教育 经验 具有 家用 就业 建议 加以 就要 经营 基于 惊讶
jz	记者 紧张 简直 机制 集中 接着 进展 竞争 价值 建筑 教主
kb	恐怖 捆绑 开本 空白 拷贝 看病 可别 开办 看不 快报 课本
kc	看出 开出 快车 课程 快餐 考察 扣除 库存 开车 开创 客场
kd	看到 刊登 扩大 口袋 快点 肯定 宽度 宽带 看得 快递 可达
kf	开发 刊发 可否 克服 咖啡 开放 开封 看法 客服 康复 客房
kg	客观 可观 看过 控股 跨国 开关 考古 可供 快感 开工 开个
kh	客户 看好 考核 开会 口号 快活 开花 抗洪 科幻 困惑 开户
kj	看见 框架 科技 靠近 可见 空间 课件 恐惧 抗拒 会计 快捷
kk	看看 开垦 苦苦 可靠 开口 快快 可口 慷慨 开阔 空空 宽阔
kl	看来 看了 快来 快乐 考虑 可怜 可乐 开了 开来 颗粒 恐龙
km	开门 快马 开幕 科贸 昆明 快门 开明 科目 苦闷 孔明 楷模
kn	可能 困难 柯南 看你 课内 苦恼 哭闹 苦难 矿难 可那 空难
kp	恐怕 开辟 开拍 卡片 宽频 可怕 快跑 开盘 科普 宽屏 考评
kq	口气 跨骑 快去 客气 况且 开启 口腔 空气 哭泣 块钱 看清
kr	客人 快如 困扰 狂人 抗日 宽容 考入 狂热 扩容 烤肉 可让
ks	开始 看书 快速 考生 看上 考试 看似 开设 亏损 款式 口水
kt	客厅 开通 开拓 看他 课堂 空调 卡特 卡通 课题 看她 开头
kv	可爱 看啊 可按 科尔 口岸 抗癌 靠岸 酷爱 克尔 凯恩 库尔
kw	渴望 库娃 可恶 看我 口味 看完 看望 可谓 课文 刊物 可为
kx	科学 空隙 康熙 苦笑 空虚 可惜 开学 开心 可笑 可选 快讯
ky	可以 考验 科研 可用 开业 抗议 跨越 快要 考研 刻意 口语
kz	控制 开展 客栈 可知 空中 看着 裤子 扩展 口中 扩张 夸张
lb	老板 两边 联邦 老爸 类别 脸部 离别 列表 路边 来吧 喇叭
lc	露出 楼层 立场 流程 理财 两次 流传 临床 列车 凌晨 历程
ld	领导 脸蛋 来到 来得 来电 力度 老道 劳动 老大 落地 料到
lf	浪费 裂缝 老夫 礼服 力帆 立法 雷锋 来访 疗法 楼房 栏肺
lg	两国 乐观 掠过 旅馆 牢固 率高 留给 两个 老公 路过 理工
lh	厉害 良好 灵魂 联合 老虎 冷汗 绿化 理会 落后 灵活 离婚
lj	立即 邻居 冷静 了解 冷峻 累计 路径 理解 连接 逻辑 脸颊
lk	离开 脸孔 拉开 来看 路口 立刻 轮廓 凌空 旅客 两款 冷酷
ll	理论 联络 连连 乐乐 力量 冷冷 来了 来历 凌厉 流露 浏览
lm	里面 罗马 路面 礼貌 联盟 连忙 两名 冷漠 浪漫 栏目 厘米
ln	理念 鲁能 岭南 两年 冷暖 辽宁 靓女 六年 老年 历年 令你
lp	老婆 脸皮 连拍 楼盘 礼品 脸庞 两片 两旁 流派 老牌 路旁
lq	离去 李强 乐趣 力气 利器 恋情 力求 篮球 录取 领取 里去
lr	老人 例如 冷热 来人 落日 利润 列入 两人 令人 录入 恋人
ls	历史 螺丝 厉声 脸色 路上 来说 泪水 立时 落实 粮食 老师
lt	老头 联通 楼梯 立体 聆听 里头 流通 老天 龙头 论坛 聊天
lv	两岸 老媪 老二 恋爱 来啊 立案 怜爱 灵儿 李敖 里奥 里昂
lw	另外 螺纹 两万 礼物 联网 论文 列为 来往 两位 例外 令我
lx	冷笑 连续 留下 联系 流星 良心 履行 类型 理想 路线 老朽
ly	利用 洛阳 领域 老爷 理由 利益 另一 旅游 留意 留言 来源
lz	来自 老子 老者 理智 两只 楼主 例子 拦住 两种 连载 留在
mb	明白 民办 目标 面包 漫步 毛病 美白 模板 面板 弥补 面部
mc	名称 冒出 马车 没错 没吃 每次 门窗 漫长 名词 摩擦 木材
md	目的 面对 猛地 矛盾 目睹 名单 密度 免得 蓦地 买到 每当
mf	麻烦 免费 密封 埋伏 莫非 魔法 美发 模仿 没法 买房 模范
mg	美国 美观 玫瑰 某个 目光 迷宫 民国 蒙古 每个 敏感 魔鬼
mh	模糊 美好 漫画 幕后 猛虎 门户 民航 梦幻 棉花 迷惑 美化
mj	面积 灭绝 民警 秘籍 模具 民间 秘诀 美军 买家 卖家 名叫
mk	门口 面孔 模块 马科 满口 没空 毛孔 煤矿 门槛 麦克 马克
ml	美丽 魅力 忙碌 命令 面临 明亮 魔力 目录 买了 名录 米兰
mm	慢慢 妈妈 买卖 面貌 明明 秘密 盲目 妹妹 默默 密码 木马
mn	美女 没能 模拟 明年 猛男 木讷 魔女 每年 迷你 泌尿 闽南
mp	门派 毛皮 门票 名牌 名品 面庞 买盘 名片 马匹 猫扑 买票
mq	目前 勉强 明确 没钱 麻雀 母亲 默契 面前 密切 门前 煤气
mr	美人 毛绒 闷热 猛然 明日 面容 每日 茫然 迷人 蓦然 美容
ms	马上 秘书 模式 面色 面上 魔兽 美术 描述 陌生 没事 美食
mt	明天 每台 每天 媒体 煤炭 眉头 命题 模特 码头 摩托 馒头
mv	名额 母爱 木耳 摩尔 明暗 命案 猫儿 木偶 马尔 梅尔 马儿
mw	门外 满屋 魔王 每位 美味 名为 每晚 骂我 面无 美文 灭亡
mx	模型 冒险 梦想 面向 明显 描写 迷信 某些 明星 慢性 买下
my	没有 绵阳 美元 每月 贸易 满意 每一 模样 命运 面议 每页
mz	名字 面子 免责 明知 满足 民族 某种 民主 帽子 妹子 盟主
nb	那边 泥巴 能把 那般 南北 内部 能不 宁波 南部 你别 你把
nc	农村 拿出 内存 昵称 南昌 年初 你才 那次 年产 农场 内测
nd	难道 你对 内地 年代 难点 年度 难度 脑袋 难得 您的 拿到
nf	能否 内附 农副 年份 南非 南方 男方 那份 奶粉 女方 农夫
ng	那个 能给 难过 能够 你跟 难怪 你该 内功 哪个 南宫 那股
nh	女孩 男孩 你还 你会 呐喊 怒火 南海 你好 脑海 您好 内涵
nj	年纪 年级 宁静 脑筋 你叫 南京 你将 那就 年间 你家 凝聚
nk	难看 农垦 那可 你看 那颗 内裤 南开 能看 宁可 尼康 那块
nl	那里 努力 你来 年利 哪里 女郎 南路 能力 内力 年龄 能量
nm	你们 农民 内幕 那么 你吗 纳米 那名 难免 匿名 纳闷 柠檬
nn	男女 奶奶 能耐 那你 喃喃 南宁 你那 你能 牛奶 年内 那年
np	哪怕 牛皮 女排 那片 尿频 你怕 男排 涅盘 牛排 内屏 奶瓶
nq	年轻 那群 拿起 怒气 扭曲 年前 弄清 你却 拿去 暖气 年青
nr	女人 懦弱 你若 男人 牛肉 内容 那日 那人 能让 纳入 你让
ns	那时 那双 女士 难受 乃是 凝视 男生 女生 那是 您是 你说
nt	念头 南通 那天 那条 难题 年头 你太 泥土 那头 你听 哪天
nv	女儿 诺阿 难熬 那儿 你啊 纽澳 南岸 哪儿 你爱 鸟儿 男儿
nw	那位 女娲 女王 那我 那晚 难忘 你问 内外 哪位 能为 挪威
nx	那些 年限 你想 你先 哪些 内心 女星 女性 男性 耐心 宁夏
ny	那样 难以 你要 能用 农业 能源 内衣 纽约 你也 女友 你有
nz	女子 男子 能在 那种 内置 拿着 那只 娘子 脑子 你真 你这
pb	旁边 碰壁 屏蔽 配备 跑步 普遍 评比 疲惫 平板 陪伴 瀑布
pc	平常 派出 跑车 赔偿 品尝 评测 排出 排除 破产 片长 跑出
pd	判断 排队 碰到 平等 盘点 频道 浦东 跑到 庞大 平淡 评定
pf	佩服 批发 牌坊 皮肤 篇幅 配方 排放 平凡 评分 频繁 票房
pg	屁股 旁观 皮革 评估 曝光 偏高 品格 苹果 跑过 飘过 排骨
ph	破坏 偏好 破获 配合 批号 平滑 跑回 平衡 排行 徘徊 彷徨
pj	平静 评级 平均 评价 瞥见 啤酒 判决 配件 破解 凭借 普及
pk	片刻 炮孔 抛开 偏科 贫困 凭空 铺开 盘口 扑克 破空 跑开
pl	漂亮 跑了 披露 毗邻 批量 评论 破了 频率 排列 疲劳 拍了
pm	拼命 平民 屏幕 排名 喷墨 平米 品名 拍卖 平面 泡沫 片名
pn	陪你 泡妞 皮囊 怕你 睥睨 叛逆 贫农 骗你 凭你 婆娘 排尿
pp	偏偏 皮皮 拍拍 品牌 频频 批评 片片 婆婆 匹配 飘飘 批判
pq	脾气 骠骑 跑去 喷泉 派遣 抛弃 片区 聘请 迫切 贫穷 排球
pr	平日 譬如 疲软 仆人 皮肉 漂染 飘然 派人 骗人 旁人 烹饪
ps	平时 评书 拍摄 迫使 爬上 配送 攀升 评审 菩萨 破碎 碰上
pt	普通 平台 配套 怕他 陪同 烹调 陪她 葡萄 平坦 拼图 菩提
pv	平安 偏爱 皮埃 配偶 佩恩 配额 拍案 破案 普尔 皮尔 帕尔
pw	颇为 片尾 喷雾 平稳 品味 盼望 评为 陪我 品位 评委 骗我
px	培训 拍戏 剖析 评选 咆哮 排序 拍下 平行 皮鞋 平息 盘旋
py	朋友 濮阳 颇有 飘逸 番禺 培养 评议 便宜 培育 拼音 平原
pz	批准 牌子 碰撞 品种 配置 凭证 胖子 品质 拍照 骗子 片子
qb	全部 墙壁 情报 确保 前辈 前部 骑兵 区别 去吧 请把 却不
qc	清楚 取出 汽车 全程 清晨 其次 球场 青春 清除 器材 全场
qd	取得 球队 全都 期待 起点 确定 驱动 强调 强大 启动 渠道
qf	气氛 群发 勤奋 缺乏 岂非 前方 前锋 欺负 侵犯 清风 起伏
qg	全国 奇观 情感 七个 求购 奇怪 牵挂 情歌 去过 器官 乞丐
qh	前后 恰好 切换 强化 漆黑 侵害 奇幻 清华 期货 气候 青海
qj	期间 全局 前进 全集 情景 奇迹 清洁 瞧见 前景 请教 情节
qk	情况 勤恳 期刊 去看 缺口 请客 晴空 请看 乾坤 千克 轻快
ql	起来 全力 强烈 权利 千里 确立 情侣 前来 权力 清理 潜力
qm	前面 巧妙 全面 签名 曲目 球迷 全民 亲密 起码 去买 奇妙
qn	去年 全能 气囊 青年 区内 气恼 潜能 请您 请你 千年 全年
qp	强迫 欺骗 汽配 亲朋 期盼 气派 切片 全屏 全盘 钦佩 俏皮
qq	轻轻 强强 请求 齐全 瞧瞧 悄悄 情趣 亲切 全球 前期 侵权
qr	情人 轻柔 亲热 亲人 七日 确认 奇瑞 全然 悄然 穷人 侵入
qs	其实 全书 轻松 全身 签署 确实 气势 起身 轻声 切实 趋势
qt	其他 前台 前提 全体 企图 其它 气体 起头 拳头 前途 群体
qv	请按 曲阿 其二 企鹅 去啊 全额 妻儿 去爱 情爱 求爱 前额
qw	千万 前卫 权威 前往 趣味 请问 气味 全文 期望 请勿 气温
qx	情形 情绪 清醒 气息 清晰 取消 缺陷 权限 全新 期限 请先
qy	企业 奇异 区域 其余 轻易 青衣 请与 权益 亲眼 球员 却又
qz	其中 妻子 求职 群众 求助 庆祝 去做 亲自 请在 去找 气质
rb	日本 入编 日报 日版 让步 如冰 人本 若不 如不 热播 人把
rc	如此 认出 人才 日程 日常 人次 热忱 热潮 日出 日产 人称
rd	人大 人对 热带 认得 热点 人道 入党 认定 人多 瑞典 弱点
rf	若非 如飞 任副 如风 如非 乳房 燃放 染发 日方 热风 人防
rg	如果 人敢 若干 入股 认购 乳沟 软管 人工 人格 绕过 日光
rh	如何 染红 日韩 然后 如虹 润滑 柔和 任何 日后 融合 荣获
rj	人家 人际 人均 如今 仍旧 人间 仍将 软件 日记 日军 日渐
rk	人口 入孔 认可 人看 入口 入库 日寇 仍可 让开 任课 瑞克
rl	人类 人力 热烈 扰乱 容量 燃料 日立 日历 人来 热量 人流
rm	人民 人马 热卖 人们 辱骂 热门 人命 入门 任命 容貌 如梦
rn	热闹 人能 忍耐 让你 日内 惹恼 若您 让您 容纳 如您 若能
rp	人品 人皮 如萍 软盘 乳品 热评 软皮 任凭 肉片 肉品 肉皮
rq	热情 人群 人权 人气 容器 日前 燃气 日期 入侵 日起 柔情
rr	仍然 容忍 如若 让人 日日 认认 柔柔 柔软 融入 软弱 柔弱
rs	认识 人参 人士 人生 若是 人数 仍是 忍受 人手 燃烧 人事
rt	如同 让她 热土 让他 认同 让它 人头 人体 软体 如图 肉体
rv	然而 人儿 入耳 热爱 人啊 乳癌 仍按 仁爱 瑞恩 瑞尔 蓉儿
rw	认为 柔婉 仍未 任务 入围 人文 若无 人物 让我 人为 日文
rx	人心 热线 如下 热血 瑞星 入学 热销 热心 人性 人选 入选
ry	人员 人又 如有 日用 容易 日益 人影 任意 如意 荣誉 日语
rz	日子 入驻 认真 入住 日照 认证 任职 日志 融资 忍者 认知
sb	身边 手臂 上班 设备 失败 生病 顺便 随便 士兵 双臂 识别
sc	市场 伸出 时辰 深处 时常 生产 适才 身材 首次 生成 输出
sd	说道 神殿 受到 似的 闪电 速度 首都 时代 手段 使得 上帝
sf	十分 沙发 是否 师父 是非 双方 身分 算法 身份 舒服 手法
sg	送给 输给 事故 三个 收购 身高 水果 时光 施工 四个 说过
sh	时候 说好 深厚 社会 收回 生活 丝毫 似乎 说话 身后 上海
sj	时间 世纪 数据 事件 世界 设计 睡觉 实际 书记 实践 随即
sk	时刻 锁孔 思考 上看 伤口 深刻 收看 书库 上课 时空 书刊
sl	上来 实力 说来 顺利 商量 设立 数量 胜利 势力 树林 森林
sm	什么 市民 上面 生命 说明 上门 四面 双目 神秘 声明 沙漠
sn	少女 谁能 深南 少年 室内 水泥 思念 首脑 上年 三年 十年
sp	水平 受骗 审批 商铺 商品 身旁 审判 食品 视频 饰品 食谱
sq	事情 四强 失去 生气 神器 神情 死去 上去 时期 上前 身躯
sr	虽然 瘦弱 骚扰 收入 生日 湿润 诗人 深入 杀人 死人 输入
ss	身上 税收 收拾 双手 说是 实施 算是 伸手 事实 神色 受伤
st	身体 说她 生态 尸体 试题 石头 试图 神态 舌头 三天 视听
sv	是啊 素娥 十二 索爱 上岸 数额 深爱 事儿 少儿 时而 所爱
sw	所谓 侍卫 尚未 上午 上网 死亡 事物 失望 事务 手腕 食物
sx	实现 视线 思想 首先 师兄 伤心 剩下 身形 实行 手下 上下
sy	所以 实验 所有 使用 事业 声音 商业 属于 适应 生意 少爷
sz	身子 始终 甚至 四周 手掌 随着 所在 实在 手指 素质 谁知
tb	特别 逃避 同比 同胞 台北 头部 她不 同伴 同步 图标 通报
tc	提出 突出 天才 特长 通常 陶瓷 掏出 推出 退出 弹出 题材
td	听到 团队 土地 她的 特点 态度 徒弟 推动 天地 提到 头顶
tf	头发 突发 土匪 通风 天赋 投放 痛风 台风 套房 推翻 颓废
tg	通过 他给 透过 提供 泰国 提高 听过 推广 太过 投稿 团购
th	谈话 挺好 桃花 体会 退回 童话 她会 他还 他会 她还 通话
tj	条件 团结 推进 途径 听见 统计 提交 天津 台阶 推荐 添加
tk	痛苦 瞳孔 推开 他看 痛哭 天空 坦克 条款 图库 太空 调控
tl	讨论 体力 透露 条例 铁路 脱离 涂料 谈论 听了 同类 叹了
tm	他们 汤姆 条码 她们 透明 甜蜜 题名 它们 题目 甜美 提名
tn	头脑 他那 天南 童年 体内 太浓 替你 他能 她那 它能 同年
tp	谈判 调皮 突破 图片 逃跑 他怕 托盘 投票 偷拍 太平 头皮
tq	提起 太强 同期 天气 天晴 同情 抬起 提前 提取 他却 听取
tr	突然 体弱 倘若 投入 同日 他让 同仁 天然 土壤 同人 坦然
ts	同时 图书 特殊 特色 天上 听说 提示 探索 天生 天色 天使
tt	太太 铁通 天天 团体 听听 抬头 贴图 偷偷 疼痛 谈谈 天堂
tv	图案 太阿 图二 胎儿 天啊 提案 徒儿 疼爱 天鹅 他爱 头儿
tw	台湾 条纹 天王 跳舞 突围 图文 图为 提问 他为 听我 听完
tx	天下 投降 停下 体系 太小 同学 图像 通信 叹息 提醒 体现
ty	统一 太阳 同样 他用 团员 同意 他也 讨厌 体育 同一 体验
tz	同志 太子 调整 体制 停止 投资 天真 通知 特征 逃走 挑战
vb	耳边 岸边 案板 欧版 而别 阿扁 二班 二百 而把 爱不 安保
vc	暗藏 二层 而成 暗处 按此 二次 暗忖 爱车 爱吃 哀愁 恩赐
vd	耳朵 而对 殴打 爱得 而当 安定 暗道 而定 额度 额定 黯淡
vf	案犯 安防 安抚 二分 而非 暗访 二房 爱抚 案发 阿飞 安放
vg	而过 二姑 爱过 二个 爱国 而该 俄国 昂贵 二哥 恶搞 耳光
vh	而后 爱好 爱护 安徽 暗黑 二话 二胡 恶化 二号 耳环 爱恨
vj	案件 二级 耳机 阿胶 暗叫 而将 而今 安静 按键 埃及 按揭
vk	安康 耳孔 阿克 儿科 爱卡 尔康 埃克 爱看 阿卡 爱哭 艾克
vl	而来 饿了 二楼 案例 恶劣 暗恋 挨了 爱恋 阿拉 二来 而立
vm	澳门 鞍马 噩梦 奥秘 欧盟 欧美 偶们 恶魔 按摩 暧昧 傲慢
vn	儿女 安妮 按扭 按钮 耳内 安宁 二女 二年 安娜 懊恼 二奶
vp	安排 鞍辔 安培 矮胖 耳畔 阿婆 爱普 耳旁 欧赔 二炮 奥普
vq	而且 鹅群 哀求 安全 暗器 爱情 二区 而起 二期 而其 案情
vr	爱人 鹅绒 阿荣 偶然 二日 而让 而入 愕然 二人 黯然 安然
vs	昂首 盎司 二十 暗算 爱上 二室 而死 二手 暗示 按时 而上
vt	儿童 而她 二厅 爱他 呕吐 额头 而逃 爱她 凹凸 而退 爱听
vv	暗暗 媕娿 偶而 偶尔 恩恩 安安 嗯嗯 阿尔 恩爱 啊啊 艾尔
vw	安危 安慰 而无 爱我 澳网 爱问 二维 额外 二位 而为 安稳
vx	恶心 二线 按下 偶像 矮小 爱心 翱翔 安心 而行 恶性 安详
vy	而已 欧阳 奥运 安逸 哎呀 遨游 阿姨 而言 恶意 而又 欧元
vz	儿子 案子 挨揍 暗自 按照 欧洲 澳洲 暗中 安装 安置 艾滋
wb	无比 尾巴 无不 我便 晚辈 未必 完毕 外表 文本 网吧 我把
wc	完成 外出 维持 无处 为此 未曾 我厂 晚餐 我才 午餐 王朝
wd	问道 我对 伟大 无敌 万吨 稳定 文档 味道 屋顶 我都 温度
wf	无法 无缝 潍坊 万分 无非 违法 微风 王府 违反 晚饭 往返
wg	我国 外观 无辜 五个 外国 无关 我刚 外挂 武功 我给 违规
wh	文化 未婚 维护 为何 我回 武汉 我会 往后 误会 温和 我还
wj	文件 未经 危机 五金 玩具 忘记 我叫 外交 玩家 网际 我家
wk	我看 微孔 外壳 外科 网卡 悟空 文库 无可 胃口 文科 我靠
wl	为了 网络 未来 为例 网路 无论 往来 完了 无力 威力 无聊
wm	我们 网民 外面 未免 文明 完美 妩媚 无名 无门 外贸 网名
wn	无奈 未能 玩弄 为你 温暖 污泥 我那 为难 为您 五年 我能
wp	物品 顽皮 我拍 文凭 外频 我怕 委派 王牌 外婆 外篇 外屏
wq	完全 委屈 为其 温泉 武器 无情 无穷 舞曲 我却 网球 误区
wr	温柔 围绕 微软 为人 往日 污染 宛如 外人 无人 万人 侮辱
ws	晚上 我司 武士 卫生 网上 完善 我说 无数 为首 卧室 无声
wt	问题 舞台 委托 为他 我听 外头 外套 网通 问他 为她 物体
wv	我爱 维阿 无碍 威尔 我啊 晚安 味儿 维尔 为爱 文案 玩儿
ww	微微 娃娃 玩玩 往往 呜呜 问问 我为 文物 威望 问我 为我
wx	微笑 危险 文献 威胁 卫星 文学 维修 无限 无心 无形 我想
wy	唯一 我也 万一 无疑 委员 无意 万元 文艺 王爷 位于 我要
wz	位置 屋子 完整 握住 为止 文章 武装 物质 为主 文字 王子
xb	宣布 下巴 相比 雪白 性别 西部 下班 想必 细胞 新版 西北
xc	形成 现出 现场 宣传 寻常 下次 写出 相处 消除 相册 行程
xd	许多 相对 想到 显得 相当 兄弟 穴道 行动 现代 晓得 小弟
xf	幸福 消费 兴奋 相反 小幅 想法 消防 西方 媳妇 修复 先锋
xg	香港 修改 性格 相公 效果 习惯 像个 相关 性感 选购 想过
xh	喜欢 小孩 相互 先后 信号 笑话 型号 协会 学会 幸好 循环
xj	小姐 下降 先进 现金 相见 选举 相机 袭击 相继 新疆 细节
xk	胸口 小孔 辛苦 学科 显卡 星空 想看 许可 新款 新开 侠客
xl	下来 训练 心理 旋律 心里 效率 想来 醒来 向来 心灵 下落
xm	项目 兄妹 下面 性命 鲜明 厦门 西门 姓名 羡慕 消灭 小麦
xn	性能 新娘 虚拟 新年 校内 西宁 想念 西南 信念 细腻 向你
xp	芯片 橡皮 选票 相片 新品 夏普 洗牌 小品 新片 胸脯 宣判
xq	想起 先驱 兴趣 香气 镶嵌 心情 小区 向前 需求 先前 星期
xr	显然 虚弱 羞辱 信任 昔日 笑容 新人 陷入 小人 行人 形容
xs	先生 吸收 迅速 学生 小时 现实 小说 形式 形势 消失 显示
xt	系统 向她 夏天 胸膛 相同 心头 向他 协调 心跳 心态 形态
xv	喜爱 狭隘 邪恶 性爱 西岸 西安 小额 相爱 小儿 限额 希尔
xw	希望 纤维 虚无 下午 香味 行为 向往 新闻 询问 学位 向我
xx	相信 学习 学校 信息 小小 小心 现象 消息 心想 谢谢 休息
xy	需要 吸引 小雨 信用 校园 协议 喜悦 效益 相应 笑意 心意
xz	现在 小子 选择 乡镇 心中 向着 限制 行政 寻找 仙子 小组
yb	一般 一边 要不 以便 一步 一半 一把 原本 拥抱 也不 邮编
yc	因此 演出 隐藏 远处 异常 一次 远程 由此 原创 一场 预测
yd	一定 一对 遇到 有的 一点 一道 一动 有点 应当 一旦 运动
yf	衣服 越发 一副 一番 一幅 依法 预防 应付 月份 一份 研发
yg	应该 勇敢 严格 有个 眼光 有关 员工 英国 阳光 月光 缘故
yh	以后 友好 疑惑 银行 雅虎 用户 也会 也好 议会 优化 遗憾
yj	已经 业绩 迎接 以及 眼睛 研究 遇见 意见 要紧 依旧 引进
yk	一块 圆孔 一款 眼看 一口 愉快 一颗 一刻 依靠 游客 一看
yl	原来 用力 以来 有利 一路 眼泪 压力 眼里 有力 原谅 一来
ym	一面 移民 迎面 以免 幽默 阴谋 也没 有名 要命 页面 一名
yn	一年 也能 云南 与你 以内 旖旎 印尼 越南 又能 因您 业内
yp	一旁 眼皮 一批 影片 用品 一派 一篇 一片 硬盘 药品 音频
yq	一切 一群 一起 语气 仪器 以前 一齐 要求 眼前 尤其 引起
yr	依然 有如 炎热 有人 一日 要让 诱人 犹如 用人 引入 艺人
ys	也是 严肃 艺术 一身 于是 意识 有所 意思 要是 一时 以上
yt	摇头 一台 一天 一条 一同 丫头 用途 一头 一套 原帖 一体
yv	因而 要隘 一二 婴儿 阴暗 议案 鱼儿 幼儿 预案 余额 延安
yw	因为 鱼尾 有无 意外 夜晚 以为 愿望 业务 以外 要闻 以往
yx	一些 有限 英雄 一向 有些 也许 以下 影响 有效 运行 优秀
yy	一样 医院 由于 应用 原因 愿意 远远 永远 意义 语言 拥有
yz	一直 一阵 一致 严重 原则 有着 影子 样子 银子 椅子 亚洲
zb	准备 嘴巴 再不 装备 逐步 转变 主板 这边 资本 指标 主办
zc	支持 指出 造成 政策 正常 再次 资产 作出 组成 自从 做出
zd	知道 指导 找到 只得 重点 制度 自动 直到 重大 值得 制定
zf	政府 总发 丈夫 作风 涨幅 执法 字符 做法 住房 支付 祝福
zg	这个 整改 职工 整个 中国 最高 总管 祖国 照顾 走过 中共
zh	之后 只好 指挥 最后 招呼 珠海 转换 最好 综合 正好 做好
zj	自己 增加 直接 资金 只见 之间 在家 之际 专家 中间 最近
zk	召开 针孔 展开 专科 张口 状况 周刊 张开 最快 这款 折扣
zl	这里 走了 总理 专利 质量 资料 整理 战略 治理 长老 治疗
zm	怎么 皱眉 正面 这么 证明 专门 桌面 咱们 著名 折磨 字幕
zn	只能 职能 指南 中年 之内 支农 在那 周年 智能 站内 在内
zp	只怕 诈骗 招聘 照片 作品 最怕 招牌 制品 自拍 这篇 栽培
zq	之前 增强 正确 赚钱 作曲 证券 抓起 追求 争取 准确 主权
zr	自然 正如 最热 众人 昨日 转让 真人 主人 责任 主任 中人
zs	只是 证书 正式 转身 真是 知识 至少 这时 正是 再说 总是
zt	总统 这台 状态 整体 主题 增添 整天 昨天 主体 专题 总体
zv	这儿 中阿 障碍 做爱 之恩 治安 周二 总额 之二 阻碍 罪恶
zw	作为 皱纹 掌握 之外 周围 中文 职务 诸位 自我 中午 昨晚
zx	这些 仔细 之下 执行 最小 主席 政协 中心 坐下 走向 转向
zy	这样 早已 只有 作用 中央 注意 怎样 重要 只要 主要 终于
zz	正在 组织 真正 增长 之中 政治 阻止 抓住 作者 战争 挣扎